NO main.c

SO main.c

F         47  ,  47, 47

WE main.c
EA main.c

C   0,  0,   0

11111111111111111111
10000000000000000001
10011111111111110001
10000000000000000111
10011111011111100001
1000000101000010000001
1000000101W00000000001
1000000110111110000001
1000000010000000000001
10000000111111111101
10000000000000000101
10000000011111110101
1000000001111111110001
11111111111111111111