NO texture/black1.xpm

SO texture/lbyad1.xpm

F         20, 32, 42

WE texture/dor1.xpm
EA texture/zrak1.xpm

C   33, 47, 60

111111111111111111111111111111111111111111111111111111111111111111111111111111111111111111
1000000000000000000000000000000000000000000000000000000000000000000000000000000000000000001
101111101111111011111110110111110111111111011111110111111101111110111111101111110111101101
101000101000001010000010010000010010000000010000010000000100000010000010000010000010001001
101010101111101010111010010111010010111110110111010101111101111010101111101011111010101011
101010100000101010000010010000010010000010000010010001000000000010010000000010000010101001
101010111111101011111110110111110110111111011111010111111101111110111111101011111110101001
101010000000101000000010010000010010000010000010000010000000000000010000010010000000001001
101111101111101111111111110111111010111111111011111111111101111111111111101111101111101101
1000000000000000000000000000000000100000000000000000000000000000000000000000000000000000001
101101101011111011101011011101111110111011101111110111101011101110111110101011101101101101
101001000010001010001000000001000000010010001000000010001010001010000010001010001000100001
101101111010111010111110110111010110011111110111110111111011101111010110101110111111101101
101000001010001000001010000010010010010001000000010010000010010010010000010010010000010001
101111101111101111111111111110111011011101111111111110111110110111111011111101111101111101
101010111111101011111110110111110110111111011111010111111101111110111111101011111110101001
101010000000101000000010010000010010000010000010000010000000000000010000010010000000001001
101111101111101111111111110111111010111111111011111111111101111111111111101111101111101101
1000000000000000000000000000000000100000000000000000000000000000000000000000000000000000001
101101101011111011101011011101111110111011101111110111101011101110111110101011101101101101
101001000010001010001000000001000000010010001000000010001010001010000010001010001000100001
101101111010111010111110110111010110011111110111110111111011101111010110101110111111101101
101000001010001000001010000010010010010001000000010010000010010010010000010010010000010001
100000000000000000000N000000000000100000000000000000000100000000000000000000000000000000001
111111111111111111111111111111111111111111111111111111111111111111111111111111111111111111
