NO texture/ledhmr.xpm

SO texture/ledkhdr.xpm

F         23, 32, 42

 WE texture/ledbnf.xpm
EA texture/ledzrk.xpm

C   3, 0, 0

       1111111111111111111111111
111     10000000011000000000000111111111111111111111111111111
101     101100000111000000000000111110111111111011100000010001
111    11111111111  11111111111111110111111111011100000010001
       1001000001  1000000000001111101111111110111000000100011
111111111011000001 1000000000000111111111111111111111111111111
100010000001100000111011111111111111       1111111111111111
1111011111111101110000001000111110111111111011100000010001
1111011111111101110101001000111110111111111011100000010001
11000000110101011100000010001111101111111110111000000100011
10000S000000000000000000000000000000000000000000000000000001
1000000000000000110101001000111110111111111011100000010001111
1100000111010101111101111000000000000000000000001000000100011
1111011111110101 10111101000000110111111111011100000010001111
11110111 1111111 11111111111100110111111111011100000010001
1111011111111101110101001000100110111111111011100000010001
1100000011010101110000001000100110111111111011100000010001
1000000000000000000000001000100110111111111011100000010001
1000000000000000110101001000100110111111111011100000010001
110000011101010111110100110001001111       111 111110011111
1111011111110101 101110001000100110111111111011100000010001
11110111 1111111 111110011111111111111111111111111111111111
11110111 1111111 111110011111100110111111111011100000010001
1111011111111101110101001000100110111111111011100000010001
1100000011010101110000001000100110111111111011100000010001
100000000000000000000000100010011011111111101110000001000111
100000000000000011010100100010011011111111101110000001000010111
11000001110101011111011110001001111       111  1111111111111
1111011111110101 10111101000100110111111111011100000010001
11111111 1111111 11111111111111111111111111111111111111111