
NO texture/black.xpm

SO texture/lbyad.xpm

F         111, 111, 111

WE texture/dor.xpm
EA texture/zrak.xpm

C  134, 206, 235

111111111
1000S1001
111111111